_______________________________
|_U_    |    ___|___    |    ___|
|    ___    |       |   ____    |
|___|   |_______|___________|   |
|           |       |   ________|       
#.####..##.#.##.....#.##...####..
..###.#.####.#..#.#.#..#.. .###.#
.#.###.#.#.#..#.#.....##.#.....#.
...##...###.#..##..###.#.#######